###########################################################################
#.##.#......#.#..##...#...###.##...###.##.#..#..##...#..#.#....#..#...#..##
S....####.##...#....#.###.......##..........#.#..#.##.#.#.#.#.##.#.##...#.#
##.#...#....##.###.##..##.####.##.#.#.##.##...##....#...#...#.##....#.#...#
#.#.#.###.#.....##.#.##.##..##..#.###.#####.#....#.#.#...#.#....#.#...##.##
#......##.#.#.##...........#...#..#.#..#.....#.#.#.#...##..#####.##.##...##
###.#####..#..#.###.##.###..##...#..#.##.###.##.##...#.#.#.....#.##.##.#.##
#......#..###...#.#.#.####.####.#.#...##.##.#......###...#.##.##.#.#.##...#
###.##.#.#..##.##...#.##...#.#..#..#.##.#...#####...#.####...#.#.#...##.#.#
#.#.##.....#.###..##.....#.#.#.###......##.#.##.#.##..#...#.##...##.##...##
#...#...####.####.###.#.#.......###.#.###..#..#.##..#.###.....##..#.##.##.#
#.##..#...#....###.##.#.#.####.##....#....##.#....#.....##.##....##.......#
#..##.#.#...##...#.#.#...#....#...#.##.##..#.##.#...##.#...####.#...####.##
#.##.#.##.##...###.#..##...##.##.#..#..###.#..#.#.#..##.#.###...###..#.#..#
###.....#..#.###....#..#.###.....##..#.######.#..#.#..#.#.##..#..###...##.#
##.#.##...##.#...#.##.#..#..#.#.##.##...#.#.....##...##.....#.##.....##...#
#......##.#..#.####....#...##.#.#...##.##.####.###.###...##.#.#..#.##.#####
#.#.#.#..#.#......###.#...#...#.###.##.#...#.#.##.#....#.###.#.#.#.#....#.#
###..#.#.....#.###.#....#..#...##........#...#.#..##.##.####.#.#.#..##.##.#
#.##...###.##..#.#...#.#..#..#...##.#.##..##.....#...##........#.#####.#..#
#.##.###....#.#....###.##.#.##.##.#.#...###.###.#..#..##.###.##......#.##.#
#..####.#.#.#.##.#.###...#.#......##..##....#####.##.#...###...##.##....#.#
##...#..#.##...#.#.#...#.#...#.##.##.#.##.#...#.....#.##.#.##.#.#.###.##..#
##.###.#...#.#.###.##.##.#.#.#.####.....#..#.###.#.##.##.#......#...#..##.#
##.#....##.#.##..#...#..#.##.###....##.###.#...##.##.....##.###...###.###.#
#..#.#.###.#..#.##.##..##........####.####.##.#...##.#.##...###.#.#.#...#.#
##.#.###....#.....###.##..#.#.##..........##..##.#...###.##....##...#.##..#
##.#.##..#####.#.#......###.#..#####.#.##.#..#....##...#..#.#.#.##...##..##
#.....#.#....#####.#.#.#.....#.##....#..#...#..#.###.###.#...##.#..##.##..#
###.#...##.#.#.##..###..##.#..#..#.#.#.##.#.#.#.....#.##.###.#...#.##...#.#
###.#.#....##...##..##.#..###.##...##....##.##.###.#.......##..###...##...#
##..#.#.###..#.#...#..#..#.....##.#...###.#.##..##.###.##.#...#.....#...###
#..#..#....#.....#.##.##...####.#.##....#.#...#.##....#...##.###.##.#.#...#
#.###.#.#.#.##.##........###.....###.####...##......#..##.##.#.....#...####
#.#.#####.....#.#####.#.###.#.##.......#..##.#.##.#.##..#......###.#.#.#..#
#.....#..#.#.##.#####..#..#...##.#.##.#.#..#.###...#.###.#.###..#..#..##.##
##.#.###..#.##...#...#.#.####.##..###.#...##...##.##.....#.####.####.#.#..#
####.#...#..#..#..##..#...#.###..##.##..####.#.##.#..###.##...#......#...##
#..#..##.##..###.#...#..#.#....#.#..###..##..##.....#..#.#.##...#.##..#.###
#.##.#....##..##..##.##..#..##.####.....#..#.#.#.##...#.##....##...###..#.#
#....####...#....##..###.####...#...###.##.....#.#..##..#..##.#..#.....##.#
#.##......###.##....#..#....#.##.##...#.##.###...##.##.#.#.#.#.##.#.##.##.#
##...##.###...#.#.####...#.##.#.....###....####.#.##......#....#.....##...#
#.##.#..##..#....#.##.#.#......##.####..####......##.##.##.#.###.###.#..#.#
#.##.##....###.#.#..#..#.##.#.###.#..##.#..###.#.##...#....#.#...#...##.###
#....##.##...##....#..#..##.#.......#.###.#..#.#.#####.#.###...#####.##...#
#.##...#####...##.###...####.###.#.##.#...#.#.###..#.......##.##.##...#.#.#
###...###..###..#.####.##..#.#.#.#.##...#...#..###..##.##.#..#......#....##
#..##.##..#...###..###..##.#.....#####.####..#.....#.#.##...##.##.##..##.##
##..##..#.###.#.##...##......##.#.#.....###.#..#.##..#...#.......#.##..#.##
#.#.###.#.....#..###....##.#.#..#.#####.###.##.#....#..##..##.#.#...##.#..#
#.#..##.#.#.#.##...#.##..##..###.......##.#.#...##.###...#...##...#.#.#####
#.#.#...#.###....#...###.###....###.##.#......##.....#.###.#.#..#.###.#...#
#...##.####...#.#.#.#......####.....###.##.##.##.####.##...#.##.#.....#.###
#.#.#....#.#.##...#.##.##.#..##.#.###...##..##....#......#.#.#.#..##.##...#
##...##.##...#...###....#..#...#..#.###..###.##.##.#.##.##.#.#.##.#.....#.#
##.###..#..##..#...##.###.#.#.#..#....##.###.#.....#..#.##.##.....##.##..##
##.#.#.#.###.#..##.#..#.....#.###..##......#...##....##...#...###..#.#.#..#
##.......###.###.##.#####.##...#####..##.#....###.#.######.#.##.##..##.##.#
#..##.###..#.##.......#......##.#....#.###.##..#..#........#.#...##.#....##
##.#..##.#.#...##.##.####.##.##...##...##.####.##.###.###.#.#..####.#.##.##
##.##....#.#.#....##......#.....###..#.##.##.#..#....##..#....#.#...#..#..#
#...##.#...###.##..##.####..#.#...#.##.......#.#.###.#.#.##.#....#....#.#.#
#.##.#.#.#.....##.#.#.#...#.#..#.#.#.##.######.#.........#...###.#.##.#.###
#.##..###..#.#..#.#...#.#.#..#.##....##.###.###.####.###..##.###...#.##...E
#....#.##.#####.#..#....#######.####.#..#.....#.#.....###.##.####.#.....#.#
####.....#.##.#.####.#.##....#........#...#.#...#.#.#..#.##....##...#.###.#
##..####......##....####..#.##.##.#.#..#.#.#.#.##.#.##.#.#..##..##.#....#.#
#..##...#.###.####.#.#.#.#.#.#.##..#..#.......##.#...#...##..##..##.##.##.#
##.##.##.####...#......#.........#.##..#.##.####.##.####.####...#.#.....###
#.........#...#...#.##.#.#.##.##.##...##.##...#...#....###....#....#.##...#
###.#.###.####..###.#...#....#.#...#.#.#...##...#.#####....###..###.#.#.###
#.###...#..###.#....#####.#.##.###..#....###.##.#.##..####.###.####.......#
#.....####......#.#.......#.....##.#..##......#.#...#......#.....#..##.#.##
###########################################################################
